Year,County,Month,Male,Female,Unknown,Total
2018,Allegany,1,3,3,0,6
2018,Allegany,10,8,7,0,15
2018,Allegany,11,5,6,0,11
2018,Allegany,12,11,3,0,14
2018,Allegany,2,3,2,0,5
2018,Allegany,3,7,2,0,9
2018,Allegany,4,6,7,0,13
2018,Allegany,5,5,9,0,14
2018,Allegany,6,4,1,0,5
2018,Allegany,7,4,1,0,5
2018,Allegany,8,10,2,1,13
2018,Allegany,9,4,6,0,10
2019,Allegany,1,3,6,0,9
2019,Allegany,10,10,5,0,15
2019,Allegany,11,4,2,0,6
2019,Allegany,12,7,1,0,8
2019,Allegany,2,4,3,0,7
2019,Allegany,3,3,5,0,8
2019,Allegany,4,7,4,0,11
2019,Allegany,5,22,7,0,29
2019,Allegany,6,7,3,0,10
2019,Allegany,7,9,8,0,17
2019,Allegany,8,10,2,0,12
2019,Allegany,9,10,6,0,16
2020,Allegany,1,6,4,0,10
2020,Allegany,2,5,5,0,10
2020,Allegany,3,3,0,0,3
2020,Allegany,4,0,0,0,0
2020,Allegany,5,0,0,0,0
2020,Allegany,6,14,14,0,28
2018,Carroll,1,3,7,4,14
2018,Carroll,10,11,5,0,16
2018,Carroll,11,10,7,0,17
2018,Carroll,12,9,6,0,15
2018,Carroll,2,14,10,0,24
2018,Carroll,3,14,12,1,27
2018,Carroll,4,16,8,0,24
2018,Carroll,5,11,4,0,15
2018,Carroll,6,1,0,1,2
2018,Carroll,7,6,5,0,11
2018,Carroll,8,3,3,0,6
2018,Carroll,9,1,2,0,3
2019,Carroll,1,16,4,0,20
2019,Carroll,10,24,6,0,30
2019,Carroll,11,8,12,0,20
2019,Carroll,12,15,5,0,20
2019,Carroll,2,5,4,0,9
2019,Carroll,3,2,13,0,15
2019,Carroll,4,9,6,0,15
2019,Carroll,5,14,9,0,23
2019,Carroll,6,17,15,1,33
2019,Carroll,7,9,8,0,17
2019,Carroll,8,6,7,0,13
2019,Carroll,9,13,9,0,22
2020,Carroll,1,15,9,0,24
2020,Carroll,2,8,3,0,11
2020,Carroll,3,14,13,0,27
2020,Carroll,4,2,0,0,2
2020,Carroll,5,0,3,0,3
2020,Carroll,6,24,15,0,39
2018,Harford,1,16,15,0,31
2018,Harford,10,19,10,0,29
2018,Harford,11,13,18,1,32
2018,Harford,12,18,19,1,38
2018,Harford,2,12,9,0,21
2018,Harford,3,11,10,0,21
2018,Harford,4,10,10,0,20
2018,Harford,5,25,11,0,36
2018,Harford,6,12,6,1,19
2018,Harford,7,9,12,2,23
2018,Harford,8,10,10,1,21
2018,Harford,9,19,7,1,27
2019,Harford,1,12,7,0,19
2019,Harford,10,26,19,0,45
2019,Harford,11,11,16,0,27
2019,Harford,12,13,9,0,22
2019,Harford,2,15,13,0,28
2019,Harford,3,14,16,0,30
2019,Harford,4,20,14,1,35
2019,Harford,5,27,18,0,45
2019,Harford,6,23,15,0,38
2019,Harford,7,25,24,0,49
2019,Harford,8,15,16,2,33
2019,Harford,9,18,14,0,32
2020,Harford,1,20,17,0,37
2020,Harford,2,17,11,0,28
2020,Harford,3,7,9,0,16
2020,Harford,4,2,0,0,2
2020,Harford,5,7,4,0,11
2020,Harford,6,27,21,0,48
2018,Saint_Marys,1,7,3,0,10
2018,Saint_Marys,10,22,8,0,30
2018,Saint_Marys,11,15,3,0,18
2018,Saint_Marys,12,7,7,0,14
2018,Saint_Marys,2,16,5,0,21
2018,Saint_Marys,3,10,10,0,20
2018,Saint_Marys,4,9,5,0,14
2018,Saint_Marys,5,12,11,0,23
2018,Saint_Marys,6,11,13,0,24
2018,Saint_Marys,7,3,8,0,11
2018,Saint_Marys,8,12,7,0,19
2018,Saint_Marys,9,15,14,0,29
2019,Saint_Marys,1,11,4,0,15
2019,Saint_Marys,10,23,6,0,29
2019,Saint_Marys,11,12,5,0,17
2019,Saint_Marys,12,16,5,0,21
2019,Saint_Marys,2,7,7,0,14
2019,Saint_Marys,3,11,14,0,25
2019,Saint_Marys,4,14,7,1,22
2019,Saint_Marys,5,15,20,0,35
2019,Saint_Marys,6,17,13,0,30
2019,Saint_Marys,7,13,14,0,27
2019,Saint_Marys,8,18,15,0,33
2019,Saint_Marys,9,23,15,0,38
2020,Saint_Marys,1,8,7,0,15
2020,Saint_Marys,2,13,6,0,19
2020,Saint_Marys,3,8,10,0,18
2020,Saint_Marys,4,0,0,0,0
2020,Saint_Marys,5,2,1,0,3
2020,Saint_Marys,6,32,35,2,69
2018,Anne_Arundel,1,34,16,1,51
2018,Anne_Arundel,10,48,44,0,92
2018,Anne_Arundel,11,49,33,2,84
2018,Anne_Arundel,12,37,40,1,78
2018,Anne_Arundel,2,34,18,2,54
2018,Anne_Arundel,3,42,30,0,72
2018,Anne_Arundel,4,36,23,0,59
2018,Anne_Arundel,5,35,31,2,68
2018,Anne_Arundel,6,24,29,4,57
2018,Anne_Arundel,7,37,26,4,67
2018,Anne_Arundel,8,37,32,2,71
2018,Anne_Arundel,9,24,15,2,41
2019,Anne_Arundel,1,43,33,1,77
2019,Anne_Arundel,10,60,44,0,104
2019,Anne_Arundel,11,33,38,2,73
2019,Anne_Arundel,12,46,35,5,86
2019,Anne_Arundel,2,44,35,3,82
2019,Anne_Arundel,3,41,35,0,76
2019,Anne_Arundel,4,43,42,2,87
2019,Anne_Arundel,5,42,48,4,94
2019,Anne_Arundel,6,54,50,3,107
2019,Anne_Arundel,7,59,38,3,100
2019,Anne_Arundel,8,61,40,8,109
2019,Anne_Arundel,9,58,36,5,99
2020,Anne_Arundel,1,35,51,5,91
2020,Anne_Arundel,2,31,35,4,70
2020,Anne_Arundel,3,26,17,1,44
2020,Anne_Arundel,4,1,9,0,10
2020,Anne_Arundel,5,16,13,2,31
2020,Anne_Arundel,6,67,62,6,135
2018,Cecil,1,6,2,0,8
2018,Cecil,10,5,3,0,8
2018,Cecil,11,7,7,0,14
2018,Cecil,12,3,9,0,12
2018,Cecil,2,3,2,1,6
2018,Cecil,3,3,6,1,10
2018,Cecil,4,9,3,0,12
2018,Cecil,5,4,4,0,8
2018,Cecil,6,6,3,1,10
2018,Cecil,7,10,4,0,14
2018,Cecil,8,5,5,0,10
2018,Cecil,9,6,0,0,6
2019,Cecil,1,8,4,0,12
2019,Cecil,10,10,5,0,15
2019,Cecil,11,4,1,0,5
2019,Cecil,12,8,3,0,11
2019,Cecil,2,1,3,1,5
2019,Cecil,3,8,6,0,14
2019,Cecil,4,10,15,0,25
2019,Cecil,5,9,8,0,17
2019,Cecil,6,7,5,0,12
2019,Cecil,7,11,4,0,15
2019,Cecil,8,15,10,0,25
2019,Cecil,9,13,6,0,19
2020,Cecil,1,13,6,0,19
2020,Cecil,2,6,3,0,9
2020,Cecil,3,3,1,0,4
2020,Cecil,4,2,1,0,3
2020,Cecil,5,14,7,0,21
2020,Cecil,6,18,19,0,37
2018,Howard,1,17,9,0,26
2018,Howard,10,7,9,1,17
2018,Howard,11,10,10,0,20
2018,Howard,12,6,6,0,12
2018,Howard,2,10,13,0,23
2018,Howard,3,5,12,0,17
2018,Howard,4,10,7,0,17
2018,Howard,5,6,11,0,17
2018,Howard,6,9,4,0,13
2018,Howard,7,4,6,0,10
2018,Howard,8,7,9,0,16
2018,Howard,9,6,9,0,15
2019,Howard,1,18,19,0,37
2019,Howard,10,13,7,0,20
2019,Howard,11,6,9,0,15
2019,Howard,12,8,19,0,27
2019,Howard,2,7,14,0,21
2019,Howard,3,6,3,0,9
2019,Howard,4,12,16,0,28
2019,Howard,5,11,9,0,20
2019,Howard,6,12,5,1,18
2019,Howard,7,19,12,0,31
2019,Howard,8,6,12,1,19
2019,Howard,9,10,14,0,24
2020,Howard,1,17,16,0,33
2020,Howard,2,16,11,0,27
2020,Howard,3,14,13,0,27
2020,Howard,4,6,4,0,10
2020,Howard,5,5,6,0,11
2020,Howard,6,17,11,0,28
2018,Somerset,1,1,0,1,2
2018,Somerset,10,4,1,0,5
2018,Somerset,11,2,1,0,3
2018,Somerset,12,3,1,0,4
2018,Somerset,2,1,0,0,1
2018,Somerset,3,0,1,1,2
2018,Somerset,4,1,1,1,3
2018,Somerset,5,1,2,1,4
2018,Somerset,6,8,1,0,9
2018,Somerset,7,4,1,0,5
2018,Somerset,8,5,4,0,9
2018,Somerset,9,4,2,0,6
2019,Somerset,1,4,2,0,6
2019,Somerset,10,3,1,0,4
2019,Somerset,11,1,10,0,11
2019,Somerset,12,1,5,0,6
2019,Somerset,2,3,1,0,4
2019,Somerset,3,3,2,0,5
2019,Somerset,4,1,0,0,1
2019,Somerset,5,4,9,0,13
2019,Somerset,6,5,4,0,9
2019,Somerset,7,1,3,0,4
2019,Somerset,8,8,1,0,9
2019,Somerset,9,3,3,0,6
2020,Somerset,1,4,2,0,6
2020,Somerset,2,1,1,0,2
2020,Somerset,3,2,2,0,4
2020,Somerset,4,0,0,0,0
2020,Somerset,5,2,1,0,3
2020,Somerset,6,7,1,0,8
2018,Baltimore_City,1,42,69,2,113
2018,Baltimore_City,10,50,79,2,131
2018,Baltimore_City,11,60,55,3,118
2018,Baltimore_City,12,46,41,1,88
2018,Baltimore_City,2,52,41,1,94
2018,Baltimore_City,3,49,56,1,106
2018,Baltimore_City,4,47,56,0,103
2018,Baltimore_City,5,66,69,2,137
2018,Baltimore_City,6,66,63,0,129
2018,Baltimore_City,7,46,66,1,113
2018,Baltimore_City,8,54,86,0,140
2018,Baltimore_City,9,65,66,1,132
2019,Baltimore_City,1,44,43,2,89
2019,Baltimore_City,10,53,71,3,127
2019,Baltimore_City,11,31,58,0,89
2019,Baltimore_City,12,58,62,0,120
2019,Baltimore_City,2,38,39,3,80
2019,Baltimore_City,3,39,49,3,91
2019,Baltimore_City,4,66,46,4,116
2019,Baltimore_City,5,70,71,5,146
2019,Baltimore_City,6,54,60,4,118
2019,Baltimore_City,7,58,78,0,136
2019,Baltimore_City,8,65,61,2,128
2019,Baltimore_City,9,58,72,1,131
2020,Baltimore_City,1,57,67,2,126
2020,Baltimore_City,2,51,62,4,117
2020,Baltimore_City,3,34,35,1,70
2020,Baltimore_City,4,3,1,0,4
2020,Baltimore_City,5,0,0,0,0
2020,Baltimore_City,6,28,42,1,71
2018,Charles,1,8,11,3,22
2018,Charles,10,20,18,1,39
2018,Charles,11,19,22,0,41
2018,Charles,12,19,19,0,38
2018,Charles,2,11,13,3,27
2018,Charles,3,24,19,2,45
2018,Charles,4,20,16,5,41
2018,Charles,5,23,24,7,54
2018,Charles,6,17,31,2,50
2018,Charles,7,22,20,4,46
2018,Charles,8,21,24,3,48
2018,Charles,9,17,18,1,36
2019,Charles,1,32,25,2,59
2019,Charles,10,17,17,0,34
2019,Charles,11,20,21,0,41
2019,Charles,12,16,17,0,33
2019,Charles,2,15,16,2,33
2019,Charles,3,20,20,0,40
2019,Charles,4,22,37,1,60
2019,Charles,5,30,14,0,44
2019,Charles,6,28,24,0,52
2019,Charles,7,21,25,0,46
2019,Charles,8,15,21,0,36
2019,Charles,9,17,22,1,40
2020,Charles,1,27,28,0,55
2020,Charles,2,16,15,0,31
2020,Charles,3,11,8,1,20
2020,Charles,4,3,4,1,8
2020,Charles,5,19,18,0,37
2020,Charles,6,32,27,1,60
2018,Kent,1,0,0,0,0
2018,Kent,10,0,0,0,0
2018,Kent,11,1,1,0,2
2018,Kent,12,2,3,0,5
2018,Kent,2,0,0,0,0
2018,Kent,3,0,1,0,1
2018,Kent,4,0,0,0,0
2018,Kent,5,0,1,0,1
2018,Kent,6,1,1,0,2
2018,Kent,7,0,0,0,0
2018,Kent,8,1,1,0,2
2018,Kent,9,2,1,0,3
2019,Kent,1,0,0,0,0
2019,Kent,10,2,1,0,3
2019,Kent,11,0,5,0,5
2019,Kent,12,2,2,0,4
2019,Kent,2,0,1,0,1
2019,Kent,3,0,2,0,2
2019,Kent,4,1,1,0,2
2019,Kent,5,2,3,0,5
2019,Kent,6,1,5,0,6
2019,Kent,7,0,0,0,0
2019,Kent,8,6,2,0,8
2019,Kent,9,1,1,0,2
2020,Kent,1,0,1,0,1
2020,Kent,2,2,0,0,2
2020,Kent,3,0,0,0,0
2020,Kent,4,0,0,0,0
2020,Kent,5,0,0,0,0
2020,Kent,6,1,4,0,5
2018,Talbot,1,0,0,0,0
2018,Talbot,10,1,1,0,2
2018,Talbot,11,0,0,0,0
2018,Talbot,12,1,5,0,6
2018,Talbot,2,2,1,0,3
2018,Talbot,3,1,3,1,5
2018,Talbot,4,0,1,0,1
2018,Talbot,5,1,7,0,8
2018,Talbot,6,6,5,4,15
2018,Talbot,7,1,1,0,2
2018,Talbot,8,2,4,0,6
2018,Talbot,9,2,0,0,2
2019,Talbot,1,1,1,0,2
2019,Talbot,10,1,2,0,3
2019,Talbot,11,4,0,0,4
2019,Talbot,12,1,2,0,3
2019,Talbot,2,4,1,0,5
2019,Talbot,3,1,0,0,1
2019,Talbot,4,2,1,0,3
2019,Talbot,5,1,4,0,5
2019,Talbot,6,3,1,0,4
2019,Talbot,7,2,3,0,5
2019,Talbot,8,0,0,0,0
2019,Talbot,9,2,3,0,5
2020,Talbot,1,1,0,0,1
2020,Talbot,2,4,4,0,8
2020,Talbot,3,1,0,0,1
2020,Talbot,4,0,0,0,0
2020,Talbot,5,0,0,0,0
2020,Talbot,6,0,0,0,0
2018,Baltimore,1,48,37,3,88
2018,Baltimore,10,88,74,6,168
2018,Baltimore,11,55,63,6,124
2018,Baltimore,12,52,67,4,123
2018,Baltimore,2,49,69,4,122
2018,Baltimore,3,60,63,2,125
2018,Baltimore,4,69,79,4,152
2018,Baltimore,5,52,57,5,114
2018,Baltimore,6,80,72,2,154
2018,Baltimore,7,81,57,2,140
2018,Baltimore,8,75,76,5,156
2018,Baltimore,9,61,77,6,144
2019,Baltimore,1,73,70,6,149
2019,Baltimore,10,77,71,1,149
2019,Baltimore,11,70,65,1,136
2019,Baltimore,12,63,63,1,127
2019,Baltimore,2,56,55,3,114
2019,Baltimore,3,63,71,1,135
2019,Baltimore,4,73,69,1,143
2019,Baltimore,5,87,90,2,179
2019,Baltimore,6,96,81,1,178
2019,Baltimore,7,83,79,5,167
2019,Baltimore,8,88,105,3,196
2019,Baltimore,9,70,83,1,154
2020,Baltimore,1,58,75,2,135
2020,Baltimore,2,58,72,1,131
2020,Baltimore,3,45,56,0,101
2020,Baltimore,4,10,3,0,13
2020,Baltimore,5,13,11,1,25
2020,Baltimore,6,74,90,0,164
2018,Dorchester,1,1,1,0,2
2018,Dorchester,10,7,6,0,13
2018,Dorchester,11,5,2,0,7
2018,Dorchester,12,5,3,0,8
2018,Dorchester,2,0,1,0,1
2018,Dorchester,3,5,1,0,6
2018,Dorchester,4,6,7,0,13
2018,Dorchester,5,6,2,0,8
2018,Dorchester,6,4,3,0,7
2018,Dorchester,7,0,0,0,0
2018,Dorchester,8,5,4,2,11
2018,Dorchester,9,6,2,0,8
2019,Dorchester,1,3,4,0,7
2019,Dorchester,10,6,8,0,14
2019,Dorchester,11,5,11,1,17
2019,Dorchester,12,1,4,0,5
2019,Dorchester,2,3,3,0,6
2019,Dorchester,3,6,3,0,9
2019,Dorchester,4,6,3,0,9
2019,Dorchester,5,2,6,0,8
2019,Dorchester,6,4,4,1,9
2019,Dorchester,7,4,8,0,12
2019,Dorchester,8,10,7,1,18
2019,Dorchester,9,6,11,0,17
2020,Dorchester,1,7,2,0,9
2020,Dorchester,2,4,8,0,12
2020,Dorchester,3,4,8,0,12
2020,Dorchester,4,1,0,0,1
2020,Dorchester,5,0,0,0,0
2020,Dorchester,6,4,5,0,9
2018,Montgomery,1,66,26,1,93
2018,Montgomery,10,98,66,0,164
2018,Montgomery,11,65,66,0,131
2018,Montgomery,12,56,46,2,104
2018,Montgomery,2,66,36,1,103
2018,Montgomery,3,62,48,5,115
2018,Montgomery,4,67,47,0,114
2018,Montgomery,5,65,48,9,122
2018,Montgomery,6,60,63,1,124
2018,Montgomery,7,79,60,0,139
2018,Montgomery,8,96,74,2,172
2018,Montgomery,9,72,41,0,113
2019,Montgomery,1,69,52,0,121
2019,Montgomery,10,77,63,0,140
2019,Montgomery,11,55,52,0,107
2019,Montgomery,12,57,48,0,105
2019,Montgomery,2,55,42,0,97
2019,Montgomery,3,58,58,0,116
2019,Montgomery,4,63,66,0,129
2019,Montgomery,5,86,44,0,130
2019,Montgomery,6,63,60,0,123
2019,Montgomery,7,77,70,2,149
2019,Montgomery,8,72,72,3,147
2019,Montgomery,9,89,76,1,166
2020,Montgomery,1,63,51,0,114
2020,Montgomery,2,61,51,0,112
2020,Montgomery,3,37,27,1,65
2020,Montgomery,4,1,1,0,2
2020,Montgomery,5,25,3,0,28
2020,Montgomery,6,118,90,2,210
2018,Washington,1,13,6,0,19
2018,Washington,10,24,23,0,47
2018,Washington,11,10,10,0,20
2018,Washington,12,20,10,1,31
2018,Washington,2,15,7,0,22
2018,Washington,3,22,12,0,34
2018,Washington,4,21,15,0,36
2018,Washington,5,14,23,0,37
2018,Washington,6,10,17,0,27
2018,Washington,7,18,22,0,40
2018,Washington,8,23,13,0,36
2018,Washington,9,20,15,0,35
2019,Washington,1,8,8,1,17
2019,Washington,10,24,14,0,38
2019,Washington,11,11,14,0,25
2019,Washington,12,16,15,3,34
2019,Washington,2,13,15,0,28
2019,Washington,3,20,19,0,39
2019,Washington,4,19,16,0,35
2019,Washington,5,23,14,1,38
2019,Washington,6,27,7,2,36
2019,Washington,7,19,24,0,43
2019,Washington,8,33,15,0,48
2019,Washington,9,25,22,0,47
2020,Washington,1,13,6,0,19
2020,Washington,2,16,8,0,24
2020,Washington,3,11,7,0,18
2020,Washington,4,0,0,0,0
2020,Washington,5,4,7,0,11
2020,Washington,6,22,13,1,36
2018,Calvert,1,1,0,0,1
2018,Calvert,10,11,9,0,20
2018,Calvert,11,13,3,0,16
2018,Calvert,12,8,3,0,11
2018,Calvert,2,0,0,0,0
2018,Calvert,3,1,0,0,1
2018,Calvert,4,4,2,0,6
2018,Calvert,5,4,2,0,6
2018,Calvert,6,0,0,0,0
2018,Calvert,7,0,0,0,0
2018,Calvert,8,2,3,0,5
2018,Calvert,9,7,5,0,12
2019,Calvert,1,7,3,0,10
2019,Calvert,10,10,7,1,18
2019,Calvert,11,14,4,0,18
2019,Calvert,12,10,14,0,24
2019,Calvert,2,6,4,0,10
2019,Calvert,3,10,4,0,14
2019,Calvert,4,15,11,0,26
2019,Calvert,5,10,7,0,17
2019,Calvert,6,10,2,1,13
2019,Calvert,7,14,7,0,21
2019,Calvert,8,11,9,0,20
2019,Calvert,9,9,7,0,16
2020,Calvert,1,14,3,0,17
2020,Calvert,2,7,8,0,15
2020,Calvert,3,7,2,0,9
2020,Calvert,4,5,0,0,5
2020,Calvert,5,5,5,0,10
2020,Calvert,6,13,15,0,28
2018,Frederick,1,13,10,6,29
2018,Frederick,10,21,21,2,44
2018,Frederick,11,22,7,0,29
2018,Frederick,12,20,13,0,33
2018,Frederick,2,9,13,1,23
2018,Frederick,3,15,3,1,19
2018,Frederick,4,17,13,0,30
2018,Frederick,5,19,21,0,40
2018,Frederick,6,23,11,1,35
2018,Frederick,7,19,11,3,33
2018,Frederick,8,16,13,3,32
2018,Frederick,9,31,12,3,46
2019,Frederick,1,22,17,1,40
2019,Frederick,10,24,19,0,43
2019,Frederick,11,23,13,2,38
2019,Frederick,12,15,21,0,36
2019,Frederick,2,10,14,1,25
2019,Frederick,3,18,16,0,34
2019,Frederick,4,17,26,0,43
2019,Frederick,5,30,12,0,42
2019,Frederick,6,20,16,0,36
2019,Frederick,7,28,24,0,52
2019,Frederick,8,33,18,0,51
2019,Frederick,9,21,13,1,35
2020,Frederick,1,26,27,0,53
2020,Frederick,2,15,14,0,29
2020,Frederick,3,13,16,0,29
2020,Frederick,4,5,5,0,10
2020,Frederick,5,5,3,0,8
2020,Frederick,6,18,6,0,24
2018,Prince_Georges,1,79,85,2,166
2018,Prince_Georges,10,115,121,5,241
2018,Prince_Georges,11,111,90,5,206
2018,Prince_Georges,12,84,78,8,170
2018,Prince_Georges,2,58,90,3,151
2018,Prince_Georges,3,101,90,6,197
2018,Prince_Georges,4,78,94,12,184
2018,Prince_Georges,5,92,90,6,188
2018,Prince_Georges,6,107,95,10,212
2018,Prince_Georges,7,110,101,4,215
2018,Prince_Georges,8,115,116,6,237
2018,Prince_Georges,9,106,92,3,201
2019,Prince_Georges,1,96,95,8,199
2019,Prince_Georges,10,91,107,6,204
2019,Prince_Georges,11,112,97,5,214
2019,Prince_Georges,12,94,111,8,213
2019,Prince_Georges,2,68,90,7,165
2019,Prince_Georges,3,89,80,4,173
2019,Prince_Georges,4,101,124,10,235
2019,Prince_Georges,5,100,125,12,237
2019,Prince_Georges,6,95,97,10,202
2019,Prince_Georges,7,139,148,9,296
2019,Prince_Georges,8,130,115,8,253
2019,Prince_Georges,9,102,101,7,210
2020,Prince_Georges,1,101,90,7,198
2020,Prince_Georges,2,81,85,8,174
2020,Prince_Georges,3,57,49,6,112
2020,Prince_Georges,4,9,10,1,20
2020,Prince_Georges,5,10,13,1,24
2020,Prince_Georges,6,135,138,16,289
2018,Wicomico,1,7,5,0,12
2018,Wicomico,10,8,11,0,19
2018,Wicomico,11,9,10,0,19
2018,Wicomico,12,4,9,0,13
2018,Wicomico,2,1,9,0,10
2018,Wicomico,3,7,7,0,14
2018,Wicomico,4,4,11,0,15
2018,Wicomico,5,4,5,0,9
2018,Wicomico,6,9,11,0,20
2018,Wicomico,7,10,10,0,20
2018,Wicomico,8,6,12,0,18
2018,Wicomico,9,9,17,0,26
2019,Wicomico,1,7,9,0,16
2019,Wicomico,10,11,18,0,29
2019,Wicomico,11,8,11,0,19
2019,Wicomico,12,12,4,0,16
2019,Wicomico,2,11,7,0,18
2019,Wicomico,3,9,2,0,11
2019,Wicomico,4,5,4,0,9
2019,Wicomico,5,13,8,0,21
2019,Wicomico,6,8,8,0,16
2019,Wicomico,7,6,6,0,12
2019,Wicomico,8,9,16,0,25
2019,Wicomico,9,13,12,0,25
2020,Wicomico,1,7,9,0,16
2020,Wicomico,2,11,14,0,25
2020,Wicomico,3,11,6,0,17
2020,Wicomico,4,0,1,0,1
2020,Wicomico,5,1,4,0,5
2020,Wicomico,6,14,6,0,20
2018,Caroline,1,2,1,0,3
2018,Caroline,10,2,5,0,7
2018,Caroline,11,6,11,0,17
2018,Caroline,12,1,1,0,2
2018,Caroline,2,3,1,0,4
2018,Caroline,3,6,4,0,10
2018,Caroline,4,6,3,0,9
2018,Caroline,5,1,4,0,5
2018,Caroline,6,14,9,0,23
2018,Caroline,7,3,3,0,6
2018,Caroline,8,9,2,0,11
2018,Caroline,9,5,4,0,9
2019,Caroline,1,2,1,0,3
2019,Caroline,10,9,6,0,15
2019,Caroline,11,3,5,0,8
2019,Caroline,12,9,6,0,15
2019,Caroline,2,2,2,0,4
2019,Caroline,3,0,3,0,3
2019,Caroline,4,7,5,0,12
2019,Caroline,5,4,7,0,11
2019,Caroline,6,2,3,0,5
2019,Caroline,7,4,2,0,6
2019,Caroline,8,7,3,0,10
2019,Caroline,9,7,3,0,10
2020,Caroline,1,4,0,0,4
2020,Caroline,2,1,0,0,1
2020,Caroline,3,5,1,0,6
2020,Caroline,4,0,0,0,0
2020,Caroline,5,0,0,0,0
2020,Caroline,6,5,1,0,6
2018,Garrett,1,0,0,1,1
2018,Garrett,10,3,4,0,7
2018,Garrett,11,0,2,0,2
2018,Garrett,12,2,1,0,3
2018,Garrett,2,1,2,0,3
2018,Garrett,3,4,1,0,5
2018,Garrett,4,3,0,0,3
2018,Garrett,5,2,2,0,4
2018,Garrett,6,0,0,0,0
2018,Garrett,7,2,2,1,5
2018,Garrett,8,2,0,0,2
2018,Garrett,9,3,2,0,5
2019,Garrett,1,2,1,0,3
2019,Garrett,10,5,1,0,6
2019,Garrett,11,4,0,0,4
2019,Garrett,12,1,3,0,4
2019,Garrett,2,1,0,0,1
2019,Garrett,3,2,1,0,3
2019,Garrett,4,0,0,0,0
2019,Garrett,5,0,0,0,0
2019,Garrett,6,4,1,0,5
2019,Garrett,7,2,0,0,2
2019,Garrett,8,4,3,0,7
2019,Garrett,9,5,1,0,6
2020,Garrett,1,5,0,0,5
2020,Garrett,2,1,0,0,1
2020,Garrett,3,1,0,0,1
2020,Garrett,4,0,0,0,0
2020,Garrett,5,0,0,0,0
2020,Garrett,6,4,3,0,7
2018,Queen_Annes,1,4,0,0,4
2018,Queen_Annes,10,3,5,0,8
2018,Queen_Annes,11,3,4,0,7
2018,Queen_Annes,12,3,2,0,5
2018,Queen_Annes,2,2,4,0,6
2018,Queen_Annes,3,3,0,0,3
2018,Queen_Annes,4,1,2,0,3
2018,Queen_Annes,5,4,1,0,5
2018,Queen_Annes,6,9,0,0,9
2018,Queen_Annes,7,1,1,0,2
2018,Queen_Annes,8,6,2,0,8
2018,Queen_Annes,9,3,5,0,8
2019,Queen_Annes,1,2,0,0,2
2019,Queen_Annes,10,2,1,0,3
2019,Queen_Annes,11,1,5,0,6
2019,Queen_Annes,12,3,0,0,3
2019,Queen_Annes,2,2,0,0,2
2019,Queen_Annes,3,2,4,0,6
2019,Queen_Annes,4,1,2,0,3
2019,Queen_Annes,5,3,1,0,4
2019,Queen_Annes,6,2,3,0,5
2019,Queen_Annes,7,4,2,0,6
2019,Queen_Annes,8,4,1,0,5
2019,Queen_Annes,9,2,1,0,3
2020,Queen_Annes,1,3,2,0,5
2020,Queen_Annes,2,1,2,0,3
2020,Queen_Annes,3,3,2,0,5
2020,Queen_Annes,4,1,0,0,1
2020,Queen_Annes,5,0,0,0,0
2020,Queen_Annes,6,3,5,0,8
2018,Worcester,1,2,2,0,4
2018,Worcester,10,2,4,0,6
2018,Worcester,11,15,4,0,19
2018,Worcester,12,8,2,0,10
2018,Worcester,2,1,2,1,4
2018,Worcester,3,1,1,0,2
2018,Worcester,4,2,0,0,2
2018,Worcester,5,4,1,0,5
2018,Worcester,6,2,3,0,5
2018,Worcester,7,2,4,0,6
2018,Worcester,8,15,5,0,20
2018,Worcester,9,5,1,1,7
2019,Worcester,1,7,4,0,11
2019,Worcester,10,5,5,0,10
2019,Worcester,11,4,3,0,7
2019,Worcester,12,2,5,0,7
2019,Worcester,2,0,5,0,5
2019,Worcester,3,7,2,0,9
2019,Worcester,4,5,7,0,12
2019,Worcester,5,5,6,0,11
2019,Worcester,6,7,8,0,15
2019,Worcester,7,7,1,1,9
2019,Worcester,8,8,5,0,13
2019,Worcester,9,11,6,0,17
2020,Worcester,1,4,9,0,13
2020,Worcester,2,4,1,1,6
2020,Worcester,3,4,1,0,5
2020,Worcester,4,1,0,0,1
2020,Worcester,5,2,1,0,3
2020,Worcester,6,6,2,0,8
